06 05 06 05 06 05 06 05 06
06 01 01 01 01 01 01 01 01
06 01 00 00 00 00 00 00 00
06 01 00 01 01 01 01 01 01
06 01 00 01 06 06 06 06 06
06 01 00 01 01 03 03 03 03
06 01 00 00 00 02 02 02 02
06 01 01 01 01 03 03 03 03
06 06 06 06 06 06 06 06 06
